{
  "é": "é",
  "è": "è",
  "à": "à",
  "ç": "ç",
  "ê": "ê",
  "î": "î",
  "ï": "ï",
  "ô": "ô",
  "û": "û",
  "ù": "ù",
  "ë": "ë",
  "É": "É",
  "È": "È",
  "À": "À",
  "Ç": "Ç"
}